time_of_day,day_of_week,vehicle_count_north,vehicle_count_south,vehicle_count_east,vehicle_count_west,total_vehicle_count,optimum_timing
8,1,20,30,40,50,140,70.0
12,3,10,20,30,40,100,50.0
18,5,50,40,30,20,140,70.0
22,7,5,10,15,20,50,25.0
6,1,25,35,45,55,160,80.0
14,4,15,25,35,45,120,60.0
17,2,55,65,75,85,280,140.0
9,6,30,40,50,60,180,90.0
11,3,20,30,40,50,140,70.0
16,5,45,55,65,75,240,120.0
