time_of_day,day_of_week,vehicle_count_north,vehicle_count_south,vehicle_count_east,vehicle_count_west,total_vehicle_count,green_light_time,yellow_light_time,red_light_time
6,7,1,35,8,67,111,48.196721311475414,3.984538448392836,67.81874024013175
19,1,87,85,33,68,273,74.75409836065575,3.6271781211205383,41.61872351822372
14,2,71,89,45,0,205,63.60655737704918,3.2540650256259207,53.139377597324895
10,6,10,57,77,67,211,64.59016393442623,4.400079362653225,51.00975670292054
7,6,63,53,3,11,130,51.31147540983606,4.446396296759525,64.24212829340442
20,5,76,11,29,59,175,58.68852459016394,5.522726131208722,55.788749278627336
6,6,80,80,94,26,280,75.90163934426229,3.663716089338192,40.43464456639951
18,3,71,77,74,55,277,75.40983606557377,4.142973821005199,40.44719011342103
22,7,20,13,98,22,153,55.08196721311475,5.425217216681073,59.49281557020417
10,4,17,33,71,24,145,53.77049180327869,5.47087083224692,60.758637364474396
10,5,93,52,2,20,167,57.37704918032787,4.153833227936305,58.469117591735824
23,3,63,19,13,60,155,55.40983606557377,4.3773720698600425,60.212791864566185
20,3,81,74,59,62,276,75.24590163934425,3.9098576725478487,40.8442406881079
3,1,94,15,76,51,236,68.68852459016394,5.797664635257936,45.51381077457813
7,6,37,94,44,87,262,72.95081967213115,3.355931297224741,43.69324903064411
23,2,31,69,95,24,219,65.90163934426229,5.80124826900441,48.2971123867333
2,2,10,55,33,54,152,54.91803278688525,5.0515993555060295,60.030367857608724
21,5,44,82,44,45,215,65.24590163934425,4.594716458060193,50.159381902595555
20,7,88,57,60,31,236,68.68852459016394,3.0979771823534876,48.213498227482575
1,2,32,3,82,54,171,58.0327868852459,4.426788575466025,57.540424539288075
23,4,40,3,15,95,153,55.08196721311475,4.223244315008197,60.694788471877054
11,2,7,19,65,4,95,45.57377049180328,3.4836564359253677,70.94257307227136
5,5,10,9,39,35,93,45.24590163934426,4.969228810501971,69.78486955015377
1,2,85,23,16,48,172,58.196721311475414,5.913452722104857,55.88982596641972
20,4,50,98,33,57,238,69.01639344262296,4.686566433193575,46.29704012418347
0,1,87,25,15,38,165,57.049180327868854,5.144259829331837,57.80655984279931
11,7,40,36,59,79,214,65.08196721311475,3.20535135769805,51.7126814291872
21,5,16,84,65,96,261,72.78688524590164,4.253000987450984,42.96011376664737
11,1,75,53,65,84,277,75.40983606557377,3.3490754554934874,41.24108847893274
16,1,45,20,89,60,214,65.08196721311475,4.838387506609531,50.07964528027571
9,1,31,73,12,8,124,50.32786885245902,5.815446474642464,63.85668467289852
15,3,78,37,55,5,175,58.68852459016394,4.985333197414915,56.326142212421146
14,7,79,45,30,34,188,60.81967213114754,3.2304091449432644,55.94991872390919
14,6,53,3,33,38,127,50.81967213114754,4.063998614955248,65.11632925389722
18,7,85,59,38,21,203,63.27868852459016,4.651990138322555,52.06932133708729
11,3,91,56,66,40,253,71.47540983606558,4.209623268399756,44.31496689553467
22,6,19,44,7,4,74,42.131147540983605,5.500932031425517,72.36792042759087
19,7,32,19,86,41,178,59.18032786885246,5.444013014129967,55.37565911701758
2,1,73,16,77,86,252,71.31147540983606,4.835493060309664,43.85303152985428
4,5,39,70,54,80,243,69.8360655737705,4.120373835398116,46.04356059083139
18,6,31,3,26,75,135,52.131147540983605,3.7660091212897324,64.10284333772665
6,4,96,92,92,86,366,90.0,3.317622954639388,26.68237704536061
20,4,1,13,52,79,145,53.77049180327869,4.064693050459662,62.16481514626165
8,2,96,2,38,66,202,63.11475409836065,4.239517551623159,52.645728350016185
6,6,32,87,64,29,212,64.75409836065575,5.0274687753122205,50.21843286403204
17,5,76,79,16,56,227,67.21311475409837,4.97447947289272,47.812405773008905
3,3,29,57,29,85,200,62.786885245901644,3.2103244189237707,54.00279033517458
13,1,32,54,52,72,210,64.42622950819671,4.185777946293474,51.38799254550982
17,2,76,3,12,28,119,49.50819672131148,3.5453366016520858,66.94646667703643
8,4,25,23,20,36,104,47.049180327868854,3.470438115950417,69.48038155618073
20,3,21,33,18,86,158,55.90163934426229,5.4819064492117375,58.61645420652597
1,3,65,29,52,12,158,55.90163934426229,3.1257456501487724,60.972615005588935
19,1,37,81,18,31,167,57.37704918032787,4.257548627706364,58.365402191965764
14,6,89,18,56,45,208,64.09836065573771,3.5046109672995547,52.39702837696274
6,4,45,30,24,22,121,49.83606557377049,5.637990647035422,64.52594377919408
11,5,14,59,85,44,202,63.11475409836065,4.671121539825105,52.21412436181424
7,3,97,59,30,16,202,63.11475409836065,3.6941419091305443,53.1911039925088
14,1,43,18,80,84,225,66.88524590163934,4.507281861499129,48.60747223686154
2,5,48,48,54,65,215,65.24590163934425,5.194459079109348,49.559639281546396
13,6,74,62,22,5,163,56.721311475409834,5.874354026758301,57.40433449783187
16,4,60,82,31,17,190,61.14754098360656,3.6613380127362567,55.19112100365719
3,6,66,21,61,93,241,69.50819672131146,5.658545316388036,44.83325796230051
17,3,5,23,73,21,122,50.0,5.802912342502471,64.19708765749752
7,5,8,75,9,32,124,50.32786885245902,5.749261633596198,63.92286951394478
3,5,5,29,99,29,162,56.55737704918033,4.906243070585729,58.53637988023394
1,5,72,57,71,80,280,75.90163934426229,4.889461963304123,39.20889869243358
5,3,94,30,53,31,208,64.09836065573771,4.209631899551468,51.692007444710825
21,3,31,99,51,41,222,66.39344262295083,5.257193646911364,48.34936373013781
9,6,40,63,19,77,199,62.622950819672134,4.593882055052796,52.78316712527507
3,2,75,18,31,9,133,51.80327868852459,5.0323142136848835,63.16440709779052
21,6,7,47,13,35,102,46.721311475409834,4.285373711546386,68.99331481304378
17,4,71,44,49,33,197,62.295081967213115,5.194489392129418,52.510428640657466
11,1,49,99,27,72,247,70.49180327868852,5.473414552813647,44.03478216849783
1,5,91,93,52,27,263,73.11475409836066,3.4393087698084486,43.44593713183089
9,2,61,54,23,10,148,54.26229508196721,5.498789146722684,60.238915771310104
3,1,83,54,78,77,292,77.8688524590164,4.6208895953709215,37.51025794561268
13,2,61,96,21,38,216,65.40983606557377,5.533997727270673,49.056166207155556
15,7,6,17,29,46,98,46.06557377049181,4.293905119023044,69.64052111048514
14,6,74,62,62,18,216,65.40983606557377,4.137121456149105,50.453042478277126
7,3,83,91,3,14,191,61.31147540983606,5.745182197551667,52.943342392612266
13,5,79,46,76,27,228,67.37704918032787,3.753507802645204,48.869443017026924
22,6,3,74,58,23,158,55.90163934426229,5.532636975858429,58.56572367987928
7,1,5,56,86,71,218,65.73770491803279,4.4520617175282124,49.810233364439
20,7,57,44,7,8,116,49.016393442622956,4.542286327653779,66.44132022972326
15,7,21,32,81,46,180,59.50819672131148,3.925404844468452,56.56639843422007
12,7,25,16,11,32,84,43.77049180327869,4.719126601857047,71.51038159486427
17,1,2,69,30,61,162,56.55737704918033,3.975633588828634,59.46698936199103
14,1,40,3,77,96,216,65.40983606557377,3.1178082427249567,51.47235569170127
20,1,59,19,33,18,129,51.14754098360656,3.8159958160330683,65.03646320036037
23,1,13,46,81,66,206,63.77049180327869,3.019137130219772,53.21037106650154
12,7,74,90,97,73,334,84.75409836065575,5.93506436117057,29.31083727817368
8,7,81,14,74,39,208,64.09836065573771,5.897241629459242,50.00439771480305
14,2,11,69,75,46,201,62.95081967213115,4.185465892416915,52.863714435451925
12,6,86,46,48,64,244,70.0,5.185112563018938,44.81488743698107
0,5,11,77,78,28,194,61.80327868852459,4.037418295231275,54.15930301624414
6,3,12,74,56,49,191,61.31147540983606,5.013279471257928,53.675245118906005
8,7,24,8,94,97,223,66.55737704918033,5.416290129137938,48.026332821681734
23,3,44,89,92,12,237,68.85245901639345,5.840268734076722,45.30727224952983
0,6,18,15,25,0,58,39.50819672131148,4.200636827549016,76.2911664511395
11,6,54,68,17,33,172,58.196721311475414,5.349893948868143,56.45338473965644
7,3,99,60,95,92,346,86.72131147540983,3.7977853518963562,29.480903172693814
23,7,44,9,85,47,185,60.32786885245902,5.970996911380945,53.70113423616003
10,3,7,49,37,76,169,57.704918032786885,3.077308796293053,59.21777317092006
18,2,92,2,80,47,221,66.22950819672131,4.8105864195033625,48.95990538377532
16,4,52,76,86,48,262,72.95081967213115,4.978517944953982,42.070662382914875
7,7,54,93,87,63,297,78.68852459016394,5.0641366712223865,36.24733873861368
2,7,31,69,49,60,209,64.26229508196721,3.361162736367267,52.37654218166553
2,5,50,80,7,28,165,57.049180327868854,5.815589350419391,57.13523032171175
0,1,43,50,40,38,171,58.0327868852459,3.5435498371502483,58.42366327760385
4,4,81,18,5,87,191,61.31147540983606,4.868260209719523,53.820264380444414
9,6,69,41,68,25,203,63.27868852459016,3.668028237369255,53.05328323804059
6,7,17,34,43,16,110,48.0327868852459,3.921649251063813,68.04556386369029
8,3,82,45,63,70,260,72.62295081967213,4.639375625184373,42.7376735551435
6,4,21,25,28,12,86,44.09836065573771,4.25158025569373,71.65005908856855
8,5,36,68,27,68,199,62.622950819672134,3.4806768029295188,53.89637237739835
7,6,95,92,10,25,222,66.39344262295083,3.5128092072625448,50.09374816978662
11,1,55,63,64,48,230,67.70491803278688,4.254434364488398,48.04064760272472
1,1,58,36,18,66,178,59.18032786885246,5.271848934826503,55.54782319632103
0,5,2,83,8,6,99,46.22950819672131,5.693893940543365,68.07659786273533
15,5,27,48,26,57,158,55.90163934426229,3.2523829867781484,60.845977668959556
22,3,73,20,33,48,174,58.52459016393442,4.179311722678204,57.29609811338737
22,7,34,73,43,52,202,63.11475409836065,3.30073669116863,53.58450921047073
23,1,60,63,67,64,254,71.63934426229508,3.0497774418977937,45.31087829580713
4,6,92,4,99,61,256,71.96721311475409,4.98515604793187,43.047630837314045
2,4,53,99,81,16,249,70.81967213114754,4.807348325899763,44.37297954295269
11,6,62,69,14,42,187,60.65573770491803,3.4890573414446586,55.85520495363731
7,2,78,89,50,24,241,69.50819672131146,3.701438499279192,46.790364779409344
21,2,96,3,12,2,113,48.52459016393443,3.0711232609335553,68.40428657513202
2,5,6,38,82,78,204,63.44262295081967,5.504841617083211,51.052535432097116
0,3,75,34,48,28,185,60.32786885245902,5.924071788145654,53.74805935939533
2,2,48,0,69,31,148,54.26229508196721,3.4063786103840723,62.331326307648716
4,1,93,23,55,25,196,62.13114754098361,3.6944256412958945,54.17442681772049
14,6,84,56,75,15,230,67.70491803278688,5.605228571840803,46.689853395372324
13,6,30,99,50,24,203,63.27868852459016,5.779391393868554,50.941920081541284
2,5,57,69,36,53,215,65.24590163934425,4.258882148420431,50.49521621223532
0,7,60,40,16,27,143,53.44262295081967,3.1518674168072223,63.40550963237311
4,7,23,53,57,72,205,63.60655737704918,3.118175501078458,53.27526712187236
22,4,19,45,86,55,205,63.60655737704918,4.721849598207031,51.671593024743785
13,5,36,59,89,64,248,70.65573770491804,4.1786853266795365,45.16557696840242
6,4,3,59,28,92,182,59.83606557377049,3.0859572827329638,57.07797714349655
8,7,91,56,32,85,264,73.27868852459017,4.7497571769376705,41.97155429847217
14,5,19,30,59,79,187,60.65573770491803,3.033907609767067,56.3103546853149
14,5,59,83,90,40,272,74.59016393442623,5.362115874447818,40.04772019112595
9,5,23,23,88,50,184,60.16393442622951,3.9192984681101146,55.91676710566037
12,7,49,88,54,70,261,72.78688524590164,3.1207740090276963,44.09234074507066
18,4,48,35,9,77,169,57.704918032786885,4.76505666294946,57.53002530426365
6,4,50,84,46,28,208,64.09836065573771,4.193053243299164,51.70858610096313
16,5,95,29,22,82,228,67.37704918032787,5.921401240071448,46.70154957960068
19,2,35,23,84,18,160,56.22950819672131,4.632595987511106,59.13789581576758
3,3,97,29,20,65,211,64.59016393442623,3.8257175431110246,51.584118522462745
4,7,99,85,12,40,236,68.68852459016394,5.128316593901925,46.183158815934135
22,3,65,91,32,44,232,68.03278688524591,3.814476007628134,48.15273710712596
6,3,78,6,23,14,121,49.83606557377049,5.7127298742226955,64.45120455200681
12,4,33,34,10,2,79,42.950819672131146,4.124165911522129,72.92501441634673
14,4,35,54,16,10,115,48.85245901639344,4.649605688328616,66.49793529527795
10,2,5,91,67,52,215,65.24590163934425,3.1517193114726867,51.60237904918306
3,3,38,13,46,45,142,53.278688524590166,4.278363713856693,62.44294776155314
12,3,41,9,24,29,103,46.885245901639344,5.497090618982985,67.61766347937767
6,5,57,79,93,56,285,76.72131147540983,5.416946416090026,37.86174210850014
18,4,11,15,72,17,115,48.85245901639344,3.6729556765605786,67.47458530704598
21,3,2,53,20,50,125,50.49180327868852,3.678237213031688,65.82995950827979
1,6,17,94,83,47,241,69.50819672131146,5.45191593663971,45.03988734204883
9,2,39,88,82,65,274,74.91803278688525,5.791195260507976,39.290771952606775
12,6,20,76,82,95,273,74.75409836065575,3.2860827638190107,41.959818875525244
20,6,14,69,11,7,101,46.557377049180324,4.350175918278676,69.092447032541
5,7,96,43,36,21,196,62.13114754098361,4.012362836892687,53.8564896221237
11,7,98,72,41,5,216,65.40983606557377,5.612065366372319,48.97809856805391
11,2,25,44,16,75,160,56.22950819672131,3.2505747440400565,60.51991705923863
19,6,7,99,47,56,209,64.26229508196721,3.633377827674112,52.10432709035868
10,3,99,55,27,35,216,65.40983606557377,5.257405012759483,49.33275892166675
22,4,93,83,40,78,294,78.19672131147541,3.153881546943647,38.649397141580934
6,2,86,81,98,91,356,88.36065573770492,4.477606142142868,27.161738120152222
0,5,41,56,46,56,199,62.622950819672134,4.32632110403916,53.050728076288706
0,6,43,20,17,48,128,50.983606557377044,4.003203536966246,65.0131899056567
19,2,13,67,77,44,201,62.95081967213115,4.183716945956771,52.86546338191208
12,1,77,49,98,81,305,80.0,4.589821760790699,35.4101782392093
8,1,1,32,70,65,168,57.540983606557376,3.4841020751651492,58.97491431827748
2,7,36,90,12,76,214,65.08196721311475,4.715987634850778,50.20204515203447
6,4,68,6,81,44,199,62.622950819672134,5.416296987899959,51.960752192427904
5,3,37,69,12,78,196,62.13114754098361,5.2804827893704775,52.588369669645914
7,4,40,14,99,19,172,58.196721311475414,3.461699714081321,58.341578974443266
8,4,61,81,30,63,235,68.52459016393442,3.4477484092244217,48.02766142684116
4,4,59,31,1,92,183,60.0,3.80452310323474,56.19547689676526
0,4,13,74,15,92,194,61.80327868852459,4.083224179023111,54.113497132452295
18,5,88,19,8,66,181,59.67213114754098,4.225366744225448,56.10250210823357
9,5,83,87,72,82,324,83.11475409836066,5.039091650500036,31.846154251139296
11,7,1,14,37,2,54,38.85245901639344,3.170041296497506,77.97749968710906
23,2,69,47,74,53,243,69.8360655737705,3.104018112678199,47.0599163135513
14,1,16,70,53,77,216,65.40983606557377,4.175731688831727,50.4144322455945
21,4,88,20,55,63,226,67.04918032786885,5.091491076413941,47.8593285957172
23,7,27,41,85,39,192,61.47540983606558,3.5803060288694475,54.944284135064976
8,2,65,25,96,58,244,70.0,4.924513443768755,45.07548655623124
19,1,34,13,99,54,200,62.786885245901644,3.7794844138208985,53.43363034027746
16,6,4,56,86,61,207,63.9344262295082,5.658258326440549,50.40731544405125
16,3,64,36,44,3,147,54.09836065573771,5.68706983279985,60.21456951146244
19,5,39,57,33,59,188,60.81967213114754,3.8918616128439796,55.288466256008476
11,6,75,20,8,74,177,59.01639344262295,3.6899812618897214,57.29362529548733
6,1,55,81,87,94,317,81.96721311475409,4.233911916198694,33.79887496904722
1,6,35,68,7,95,205,63.60655737704918,3.7215947555404463,52.67184786741038
2,3,44,2,6,90,142,53.278688524590166,5.017151529875111,61.70415994553473
16,7,22,86,35,29,172,58.196721311475414,5.478194053644857,56.32508463487973
4,1,46,89,17,1,153,55.08196721311475,5.0192763927336514,59.8987563941516
16,6,30,36,2,61,129,51.14754098360656,5.473051341748048,63.37940767464539
23,5,10,87,27,48,172,58.196721311475414,4.190976486622422,57.61230220190216
16,5,9,48,69,8,134,51.9672131147541,3.4689509121265827,64.56383597311932
16,2,66,18,43,91,218,65.73770491803279,5.213852842192777,49.04844223977443
1,6,13,88,20,30,151,54.75409836065574,4.081423515424662,61.1644781239196
1,4,79,84,27,97,287,77.04918032786885,5.013812475687398,37.937007196443744
21,6,73,11,53,60,197,62.295081967213115,3.811931825945297,53.892986206841584
22,7,92,60,53,78,283,76.39344262295081,3.243688904420018,40.362868472629174
4,1,9,40,64,47,160,56.22950819672131,5.97774538646329,57.7927464168154
0,1,75,32,99,24,230,67.70491803278688,3.468604523791798,48.826477443421325
0,7,93,49,20,35,197,62.295081967213115,5.965262981890444,51.739655050896445
18,6,0,67,98,7,172,58.196721311475414,5.931839797699341,55.871438890825246
1,7,4,70,12,72,158,55.90163934426229,5.381454311724119,58.71690634401359
20,3,19,85,56,57,217,65.57377049180329,4.978268886245993,49.44796062195071
11,7,7,32,48,44,131,51.47540983606557,4.733421150753254,63.791169013181175
5,5,42,80,53,61,236,68.68852459016394,5.598304636133504,45.71317077370256
22,7,75,23,9,38,145,53.77049180327869,3.868318564858464,62.36118963186285
3,1,0,60,52,95,207,63.9344262295082,4.403043637454632,51.662530133037166
22,5,56,60,43,57,216,65.40983606557377,4.858169908099506,49.73199402632672
10,1,63,97,46,80,286,76.88524590163934,4.2335714276084735,38.881182670752196
23,2,83,27,52,98,260,72.62295081967213,4.282459362270804,43.094589818057074
16,4,27,57,73,82,239,69.18032786885246,3.990854002506253,46.82881812864129
5,1,36,42,45,63,186,60.49180327868852,4.692695450053608,54.81550127125787
23,5,46,40,12,43,141,53.114754098360656,5.551723584045348,61.333522317593996
4,2,75,38,36,28,177,59.01639344262295,3.6045851340189383,57.37902142335811
19,1,36,85,23,58,202,63.11475409836065,5.803299116260324,51.08194678537903
1,3,48,48,1,70,167,57.37704918032787,5.067262961244689,57.55568785842744
5,7,43,16,85,91,235,68.52459016393442,5.46981963804009,46.00559019802549
21,4,55,97,80,8,240,69.34426229508196,4.668572077890035,45.987165627028006
10,1,27,69,99,91,286,76.88524590163934,5.338550104272191,37.776203994088476
15,2,78,69,13,5,165,57.049180327868854,3.0486011920184017,59.902218480112744
15,3,5,97,9,28,139,52.78688524590164,5.455141274338605,61.757973479759755
0,6,60,64,34,57,215,65.24590163934425,3.1204165772560994,51.63368178339965
8,2,19,73,24,16,132,51.63934426229508,5.669740129088588,62.69091560861633
5,7,77,84,2,15,178,59.18032786885246,5.97588824171593,54.843783889431606
15,2,1,4,16,86,107,47.540983606557376,3.8822023865303334,68.57681400691229
2,3,72,1,11,94,178,59.18032786885246,3.630955668857381,57.18871646229016
19,2,36,21,53,2,112,48.36065573770492,5.296090091574122,66.34325417072097
3,3,19,56,23,20,118,49.34426229508197,3.75907902276076,66.89665868215727
18,1,25,65,28,63,181,59.67213114754098,5.59668714951661,54.73118170294241
2,3,28,73,42,89,232,68.03278688524591,3.30852777647243,48.65868533828166
18,3,0,97,24,35,156,55.57377049180327,3.3778655891380747,61.04836391905865
19,4,34,15,99,85,233,68.19672131147541,5.937454665301846,45.86582402322274
6,3,69,50,59,61,239,69.18032786885246,5.021516694810014,45.798155436337524
19,3,58,38,89,41,226,67.04918032786885,5.540661673286858,47.410157998844284
8,6,68,85,64,75,292,77.8688524590164,3.972988132054554,38.15815940892905
0,1,32,75,83,41,231,67.8688524590164,5.029451248561813,47.10169629242179
7,7,50,87,27,60,224,66.72131147540983,4.782725481925792,48.49596304266437
6,4,77,39,15,12,143,53.44262295081967,4.8094503603688405,61.74792668881149
17,6,11,37,46,10,104,47.049180327868854,5.0475973786131645,67.90322229351798
7,5,19,59,80,53,211,64.59016393442623,4.726077519387296,50.68375854618648
0,1,52,58,91,15,216,65.40983606557377,4.287187107907998,50.30297682651823
10,1,87,9,57,7,160,56.22950819672131,3.8277680831416405,59.942723720137046
17,5,42,98,75,58,273,74.75409836065575,5.305743992739606,39.940157646604646
22,7,97,63,26,56,242,69.67213114754098,3.6788172900095586,46.64905156244946
9,3,88,62,52,39,241,69.50819672131146,5.077062918463243,45.414740360225295
2,6,49,48,41,58,196,62.13114754098361,3.69999846794798,54.1688539910684
6,2,28,63,58,1,150,54.59016393442623,4.875990509863362,60.53384555571041
15,4,56,31,46,93,226,67.04918032786885,5.241234801387087,47.70958487074407
15,2,38,6,93,93,230,67.70491803278688,3.6561416667196176,48.6389403004935
19,5,94,20,33,75,222,66.39344262295083,3.1798299025839247,50.42672747446525
16,1,55,19,36,9,119,49.50819672131148,3.392921228982522,67.09888204970599
1,7,42,25,5,43,115,48.85245901639344,4.817990901813077,66.32955008179349
0,1,49,67,6,10,132,51.63934426229508,5.5483392186772065,62.81231651902771
15,4,22,85,95,78,280,75.90163934426229,3.134990463706273,40.963370192031434
11,1,43,14,95,79,231,67.8688524590164,5.202453777124939,46.92869376385866
4,1,37,84,24,80,225,66.88524590163934,4.023955937850157,49.0907981605105
4,4,83,78,32,89,282,76.22950819672131,4.435585109758568,39.334906693520125
22,6,22,85,54,1,162,56.55737704918033,5.786578649536697,57.656044301282975
8,6,44,91,57,49,241,69.50819672131146,3.9959145142075365,46.495888764480995
8,4,51,13,6,11,81,43.278688524590166,4.396010801818458,72.32530067359139
2,7,79,26,56,89,250,70.98360655737704,3.0410472442820433,45.975346198340915
18,5,49,39,11,22,121,49.83606557377049,3.244796160014515,66.91913826621499
15,1,7,57,15,17,96,45.73770491803279,3.7757747734043523,70.48652030856286
15,7,84,27,79,61,251,71.14754098360655,3.083556722463223,45.768902293930225
2,1,0,25,42,95,162,56.55737704918033,4.8941259781447535,58.54849697267491
19,5,7,62,99,61,229,67.54098360655738,4.279195070404867,48.17982132303776
23,6,28,65,76,37,206,63.77049180327869,4.644435608184066,51.585072588537244
21,7,95,24,6,66,191,61.31147540983606,3.5239415576889885,55.16458303247495
23,3,4,2,99,37,142,53.278688524590166,3.887796088309848,62.833515387099986
0,3,85,71,50,66,272,74.59016393442623,4.991473424558175,40.41836264101559
23,3,46,43,72,93,254,71.63934426229508,5.895908170891199,42.46474756681371
19,6,33,96,31,60,220,66.0655737704918,3.1512503208066276,50.78317590870158
10,6,64,41,74,0,179,59.34426229508197,5.671152962565799,54.98458474235224
16,5,54,98,7,93,252,71.31147540983606,4.7306436039336255,43.95788098623031
7,1,89,5,96,44,234,68.36065573770492,4.691758700266871,46.94758556202821
3,5,42,38,86,95,261,72.78688524590164,4.500835605623281,42.712279148475076
5,5,73,51,88,27,239,69.18032786885246,3.2081822577125503,47.61148987343499
7,6,29,22,71,20,142,53.278688524590166,3.269630555208482,63.451680920201355
19,3,81,88,44,12,225,66.88524590163934,4.802736016977258,48.3120180813834
2,2,16,49,85,26,176,58.85245901639344,4.022875714306675,57.12466526929988
15,1,25,42,58,99,224,66.72131147540983,5.7518041997330425,47.52688432485712
2,6,7,18,3,6,34,35.57377049180328,4.219771612078417,80.20645789611831
17,3,46,68,66,21,201,62.95081967213115,3.429844376107923,53.61933595176092
13,7,75,50,28,73,226,67.04918032786885,5.144156500506108,47.80666317162503
17,2,90,10,28,52,180,59.50819672131148,3.8800602643230295,56.611743014365494
1,2,71,11,97,78,257,72.1311475409836,4.57641092206768,43.292441536948715
21,6,88,73,97,78,336,85.08196721311475,5.09349835651551,29.824534430369738
2,4,45,7,27,3,82,43.44262295081967,5.700792333606211,70.85658471557412
15,1,67,23,76,95,261,72.78688524590164,5.376573584405028,41.836541169693334
8,2,32,91,78,22,223,66.55737704918033,5.029083203618172,48.4135397472015
3,6,0,40,86,69,195,61.9672131147541,5.038899547185431,52.99388733806046
0,6,18,35,43,87,183,60.0,5.83777393209626,54.162226067903745
3,3,30,84,89,83,286,76.88524590163934,3.8874722924896083,39.22728180587106
0,7,79,71,3,83,236,68.68852459016394,3.0033362825885623,48.3081391272475
13,4,13,54,89,75,231,67.8688524590164,3.815863678194596,48.315283862789016
20,1,52,8,8,32,100,46.39344262295082,3.653674138880232,69.95288323816894
15,5,47,46,4,27,124,50.32786885245902,4.985503755341995,64.68662739219899
19,7,68,14,55,7,144,53.60655737704918,4.901134799296587,61.49230782365424
23,7,89,47,95,0,231,67.8688524590164,4.780384148114171,47.35076339286944
7,3,61,81,83,36,261,72.78688524590164,3.048730329628361,44.16438442447
6,2,91,41,49,62,243,69.8360655737705,5.186334163351942,44.97760026287756
2,2,65,59,74,21,219,65.90163934426229,3.9705912374564747,50.12776941828123
16,3,63,83,14,69,229,67.54098360655738,4.995167967019894,47.46384842642273
0,6,69,69,31,20,189,60.98360655737705,4.66973528550646,54.346658157116494
15,2,62,11,27,95,195,61.9672131147541,4.0281927762837215,54.00459410896218
11,4,72,1,21,34,128,50.983606557377044,3.4037288013123232,65.61266464131063
18,1,32,6,16,78,132,51.63934426229508,3.2832566929814426,65.07739904472348
21,7,40,79,58,4,181,59.67213114754098,5.494554999336671,54.83331385312235
22,7,88,2,89,59,238,69.01639344262296,5.755192626244674,45.228413931132366
21,4,47,2,70,45,164,56.885245901639344,4.949364140292898,58.165389958067756
13,2,12,26,56,49,143,53.44262295081967,3.31030234458145,63.24707470459888
5,7,72,39,25,47,183,60.0,4.206081650664722,55.79391834933527
5,5,76,32,24,5,137,52.459016393442624,5.186817600315472,62.354166006241904
12,1,30,91,9,88,218,65.73770491803279,5.339462652030204,48.922832429937
18,1,74,0,44,55,173,58.36065573770492,3.354655866873266,58.28468839542182
21,7,67,7,82,58,214,65.08196721311475,3.000092156536147,51.91794063034911
7,3,97,31,10,28,166,57.213114754098356,5.136411137641815,57.65047410825983
1,7,3,47,76,70,196,62.13114754098361,4.069788527958616,53.79906393105777
20,3,18,3,52,76,149,54.42622950819673,3.763443994854781,61.81032649694849
0,7,69,93,71,17,250,70.98360655737704,3.0386924093685765,45.97770103325438
14,5,97,69,67,1,234,68.36065573770492,4.620898220284499,47.01844604201058
0,6,81,18,94,7,200,62.786885245901644,5.553452206277945,51.65966254782042
4,1,12,31,27,74,144,53.60655737704918,5.872894938817764,60.52054768413306
15,7,22,8,74,96,200,62.786885245901644,4.697234851839868,52.51587990225849
18,5,82,11,64,53,210,64.42622950819671,4.543383983219682,51.030386508583604
3,3,74,10,48,37,169,57.704918032786885,3.255169156467723,59.03991281074539
2,3,0,45,46,47,138,52.62295081967213,4.6466184046278,62.73043077570007
16,1,87,15,51,26,179,59.34426229508197,4.139937236896184,56.51580046802185
16,4,53,0,87,19,159,56.0655737704918,4.821405842650731,59.113020386857464
11,7,70,62,53,11,196,62.13114754098361,4.16617904362964,53.702673415386755
13,2,88,20,59,42,209,64.26229508196721,3.7208973703511004,52.016807547681694
20,3,84,29,56,60,229,67.54098360655738,3.2848958256851297,49.1741205677575
5,6,14,12,46,30,102,46.721311475409834,3.944755333766687,69.33393319082347
2,6,64,33,30,90,217,65.57377049180329,3.289934502863257,51.13629500533345
8,3,75,3,45,95,218,65.73770491803279,3.5306908524719516,50.73160422949526
4,4,70,27,25,60,182,59.83606557377049,5.962008475738638,54.201925950490875
23,4,14,94,4,73,185,60.32786885245902,4.332310670719856,55.33982047682113
16,5,20,58,83,66,227,67.21311475409837,4.59561529951505,48.19126994638658
13,6,18,26,51,90,185,60.32786885245902,5.620855586211646,54.051275561329334
20,5,59,68,74,34,235,68.52459016393442,5.986706701472063,45.48870313459352
2,6,92,24,53,94,263,73.11475409836066,4.748143348034045,42.13710255360529
0,7,88,2,32,14,136,52.295081967213115,5.437421463132515,62.26749656965437
19,7,32,96,49,15,192,61.47540983606558,3.9808230730100256,54.54376709092439
20,2,48,67,37,12,164,56.885245901639344,3.9172318723418735,59.19752222601878
22,7,95,24,26,34,179,59.34426229508197,4.2081111629836805,56.447626541934355
0,2,34,19,97,74,224,66.72131147540983,5.0175217880209475,48.26116673656922
2,7,43,33,14,58,148,54.26229508196721,5.046575067765296,60.691129850267494
17,1,89,25,95,20,229,67.54098360655738,3.9457183039483525,48.51329808949427
9,7,10,4,60,53,127,50.81967213114754,3.3996297724098863,65.78069809644256
21,5,98,98,20,74,290,77.54098360655738,4.897188769396526,37.5618276240461
2,3,71,60,45,29,205,63.60655737704918,3.3849775865662934,53.008465036384536
7,5,77,91,68,47,283,76.39344262295081,4.73547752468799,38.87107985236119
13,3,73,92,5,34,204,63.44262295081967,5.080266384168927,51.47711066501141
23,4,65,8,37,85,195,61.9672131147541,5.101834489183355,52.93095239606254
17,5,45,49,61,37,192,61.47540983606558,5.26041633197879,53.26417383195563
14,4,8,5,85,30,128,50.983606557377044,5.6185782646969935,63.39781517792596
21,2,2,82,61,77,222,66.39344262295083,4.499876975894365,49.106680401154804
22,2,84,59,81,23,247,70.49180327868852,5.190747568588714,44.31744915272276
1,1,25,43,77,48,193,61.63934426229508,4.85751820609751,53.50313753160741
9,7,71,10,73,95,249,70.81967213114754,3.5599198193930475,45.620408049459414
1,5,47,65,45,99,256,71.96721311475409,3.0770689346082243,44.95571795063769
16,4,65,46,12,31,154,55.24590163934427,3.853624157030801,60.90047420362493
7,3,69,72,94,54,289,77.37704918032787,4.329101119012858,38.293849700659266
0,2,27,84,93,78,282,76.22950819672131,4.851317833285969,38.91917396999271
8,7,92,87,2,57,238,69.01639344262296,5.549877991509616,45.433728565867426
10,2,25,97,93,98,313,81.31147540983606,3.588737150118497,35.099787440045446
21,3,24,85,5,2,116,49.016393442622956,3.376649369695431,67.60695718768162
15,7,11,2,92,79,184,60.16393442622951,5.890439842422983,53.945625731347505
6,7,4,75,7,68,154,55.24590163934427,3.3241336781292214,61.42996468252651
9,4,97,91,43,84,315,81.63934426229508,4.435473210321567,33.925182527383356
22,4,47,29,32,9,117,49.18032786885246,4.756691186379905,66.06298094476765
2,5,36,89,80,82,287,77.04918032786885,4.624123262722315,38.326696409408825
17,5,78,20,74,24,196,62.13114754098361,3.2580964710988294,54.61075598791756
23,6,43,27,76,67,213,64.91803278688525,3.171080742010858,51.91088647110389
12,6,99,89,49,60,297,78.68852459016394,3.316450282383107,37.99502512745296
6,1,14,61,10,28,113,48.52459016393443,4.756763051617837,66.71864678444774
3,2,42,32,94,18,186,60.49180327868852,4.633034662902963,54.87516205840852
12,5,47,84,27,42,200,62.786885245901644,3.7012223761102327,53.51189237798812
19,4,86,34,69,65,254,71.63934426229508,4.913322425536775,43.44733331216814
0,3,69,51,40,73,233,68.19672131147541,5.460202506166948,46.343076182357635
7,4,45,33,15,60,153,55.08196721311475,3.1247368795397814,61.79329590734547
13,2,42,40,67,42,191,61.31147540983606,4.494389830644128,54.19413475951981
15,6,20,50,98,24,192,61.47540983606558,5.067931236308071,53.45665892762635
13,4,22,46,47,19,134,51.9672131147541,3.7569357812090614,64.27585110403683
11,1,79,81,55,47,262,72.95081967213115,3.9233127158794474,43.125867611989406
18,2,46,57,63,82,248,70.65573770491804,4.840913708968151,44.503348586113816
22,6,14,74,58,86,232,68.03278688524591,5.693805880331211,46.273407234422876
14,3,24,56,89,23,192,61.47540983606558,5.429773260908698,53.094816903025716
1,6,35,22,61,10,128,50.983606557377044,4.7493906572987505,64.26700278532421
1,7,74,47,75,97,293,78.03278688524591,5.190665153271747,36.776547961482336
22,1,50,21,10,54,135,52.131147540983605,4.0944674106233965,63.774385048393
21,2,14,16,88,27,145,53.77049180327869,4.922896584296273,61.30661161242504
18,3,67,68,17,68,220,66.0655737704918,4.398544773382671,49.53588145612554
21,1,20,10,18,62,110,48.0327868852459,3.5698084093726825,68.39740470538142
21,6,12,93,86,58,249,70.81967213114754,5.105214821631772,44.07511304722068
16,1,85,14,54,4,157,55.73770491803279,4.669393912046466,59.592901169920744
19,2,18,90,81,50,239,69.18032786885246,4.075864745860774,46.74380738528677
9,5,33,34,25,20,112,48.36065573770492,5.734017570235892,65.90532669205919
5,1,77,32,5,11,125,50.49180327868852,3.0628023534802,66.44539436783128
14,7,67,83,3,49,202,63.11475409836065,3.947319453748488,52.93792644789086
21,1,51,15,28,3,97,45.90163934426229,3.1706441933329397,70.92771646240476
10,6,26,33,58,41,158,55.90163934426229,5.299581948664882,58.79877870707283
4,6,28,65,97,83,273,74.75409836065575,5.106322362341378,40.13957927700288
0,3,27,98,16,37,178,59.18032786885246,3.9940566562089512,56.82561547493859
7,6,34,39,42,24,139,52.78688524590164,5.0269887066212195,62.186126047477146
20,4,7,27,79,13,126,50.65573770491803,4.187811678587849,65.15645061649411
11,2,15,46,65,74,200,62.786885245901644,5.268761374267303,51.94435337983106
11,2,35,38,33,31,137,52.459016393442624,4.362550988210119,63.17843261834726
4,5,29,69,7,10,115,48.85245901639344,4.236839183494997,66.91070180011157
6,5,17,72,12,60,161,56.393442622950815,5.804189746464903,57.802367630584286
3,2,1,19,7,17,44,37.21311475409836,3.7526372996721005,79.03424794622953
5,7,48,0,93,26,167,57.37704918032787,3.361342019989696,59.26160879968243
12,5,76,71,95,54,296,78.52459016393442,4.753629339778374,36.72178049628721
19,3,3,86,99,53,241,69.50819672131146,5.907965436852537,44.583837841836
14,6,89,62,93,81,325,83.27868852459017,4.13351764118156,32.58779383422828
2,2,88,66,64,86,304,79.8360655737705,3.1861102908863446,36.977824135343155
22,5,93,3,42,74,212,64.75409836065575,4.0179158019287025,51.227985837415545
7,2,74,57,38,20,189,60.98360655737705,4.517794962958675,54.49859847966428
19,4,6,24,80,43,153,55.08196721311475,3.485769019896641,61.432263766988605
15,1,94,46,58,4,202,63.11475409836065,4.974306654169476,51.91093924746987
12,6,73,37,83,86,279,75.73770491803279,5.993248167030602,38.26904691493661
17,2,38,14,87,40,179,59.34426229508197,4.355218427944331,56.3005192769737
9,1,12,62,85,58,217,65.57377049180329,4.064185670190637,50.36204383800607
18,5,30,20,92,88,230,67.70491803278688,4.2021125005034,48.09296946670972
16,1,70,98,85,53,306,80.1639344262295,3.3454385351856035,36.49062703858489
23,6,62,56,43,73,234,68.36065573770492,5.649820804278671,45.98952345801641
18,2,55,52,8,21,136,52.295081967213115,4.244476966564056,63.46044106622283
22,4,41,45,36,82,204,63.44262295081967,4.161823234274523,52.39555381490581
4,7,60,13,73,64,210,64.42622950819671,4.979070818791423,50.59469967301186
20,5,41,99,35,63,238,69.01639344262296,4.3261002627933705,46.65750629458367
22,2,55,75,91,70,291,77.70491803278688,4.944700406423538,37.350381560789586
8,6,35,16,27,3,81,43.278688524590166,3.1843388703923625,73.53697260501747
11,5,83,38,41,64,226,67.04918032786885,5.441170031166682,47.50964964096447
20,3,67,8,42,14,131,51.47540983606557,5.821511858638208,62.703078305296216
0,1,6,98,84,75,263,73.11475409836066,4.946296158478158,41.938949743161174
0,7,53,76,87,21,237,68.85245901639345,5.863697786576433,45.28384319703011
14,6,0,78,41,85,204,63.44262295081967,3.45429694310989,53.103080106070436
1,3,43,81,65,46,235,68.52459016393442,4.432248568441061,47.04316126762453
21,2,44,96,54,80,274,74.91803278688525,4.805420201836341,40.27654701127841
15,4,46,5,71,92,214,65.08196721311475,4.7452099422635605,50.17282284462169
7,5,12,90,47,45,194,61.80327868852459,4.20438533726713,53.992335974208274
12,1,21,22,90,13,146,53.9344262295082,4.014253228098784,62.051320542393015
20,5,20,58,21,49,148,54.26229508196721,3.3804720676512563,62.357232850381536
0,7,85,90,26,19,220,66.0655737704918,4.175227351686835,49.759198877821376
15,2,91,97,92,49,329,83.9344262295082,3.4879824453164554,32.577591325175334
6,5,8,45,66,32,151,54.75409836065574,5.203097029476655,60.0428046098676
4,1,25,37,12,58,132,51.63934426229508,3.62649280648377,64.73416293122115
21,2,8,13,44,42,107,47.540983606557376,3.1756959158536016,69.28332047758903
22,5,14,99,9,78,200,62.786885245901644,4.657098413451703,52.55601634064665
2,4,9,71,99,11,190,61.14754098360656,4.785689198158205,54.06676981823523
11,6,87,61,8,39,195,61.9672131147541,5.615739183841517,52.417047701404385
15,2,41,34,53,19,147,54.09836065573771,4.730944837253046,61.170694507009244
18,6,71,18,26,93,208,64.09836065573771,4.036442561170337,51.86519678309196
4,2,23,29,33,37,122,50.0,5.409035644578962,64.59096435542104
21,4,79,77,0,2,158,55.90163934426229,4.620836679562263,59.47752397617545
13,6,48,83,31,27,189,60.98360655737705,3.2378408538935752,55.77855258872937
4,3,25,24,88,55,192,61.47540983606558,4.69755168093974,53.82703848299468
14,1,90,39,92,89,310,80.81967213114754,5.724055636264987,33.456272232587466
16,3,36,87,70,93,286,76.88524590163934,4.188937876494662,38.925816221866
13,5,67,13,66,12,158,55.90163934426229,3.8889774056994,60.20938325003831
19,4,49,25,83,76,233,68.19672131147541,3.4304083710540603,48.37287031747053
4,3,23,86,19,65,193,61.63934426229508,3.454336565806072,54.90631917189884
11,2,18,21,93,36,168,57.540983606557376,4.298314453025457,58.16070194041717
15,5,99,47,34,48,228,67.37704918032787,4.787039472484588,47.83591134718753
15,5,59,82,98,65,304,79.8360655737705,3.2418462155088053,36.9220882107207
20,3,38,50,90,35,213,64.91803278688525,5.818705767075497,49.26326144603925
6,3,73,2,89,53,217,65.57377049180329,5.2654008523355875,49.160828655861124
3,4,88,41,77,25,231,67.8688524590164,4.7598717548509875,47.371275786132614
0,1,17,18,16,74,125,50.49180327868852,5.4853160128169725,64.02288070849451
4,3,18,72,17,71,178,59.18032786885246,3.24056027043634,57.5791118607112
22,7,35,27,44,39,145,53.77049180327869,4.430516633199373,61.79899156352194
9,3,73,83,92,42,290,77.54098360655738,4.890279380584991,37.56873701285764
21,6,96,44,83,21,244,70.0,5.485958718354867,44.514041281645135
4,2,54,70,52,19,195,61.9672131147541,5.350408680147803,52.68237820509809
3,7,68,77,90,7,242,69.67213114754098,3.831207749140199,46.496661103318814
1,7,46,62,81,28,217,65.57377049180329,5.822640508677613,48.603588999519104
19,6,48,72,67,39,226,67.04918032786885,3.373037524292611,49.57778214783853
9,6,98,18,64,89,269,74.09836065573771,5.6254008558634565,40.27623848839883
18,5,97,46,0,29,172,58.196721311475414,5.912820748813855,55.89045793971073
0,1,32,13,57,80,182,59.83606557377049,3.5314605696678765,56.63247385656163
23,2,20,37,25,83,165,57.049180327868854,5.166198192611356,57.78462147951979
4,4,80,52,19,54,205,63.60655737704918,3.1208565563339956,53.272586066616824
12,7,21,60,86,15,182,59.83606557377049,4.216268475417465,55.94766595081205
3,4,47,35,9,45,136,52.295081967213115,4.548849897593022,63.15606813519386
15,3,36,39,58,61,194,61.80327868852459,4.741935677728902,53.45478563374651
23,3,14,80,74,6,174,58.52459016393442,5.8078117447456785,55.6675980913199
15,4,34,29,40,79,182,59.83606557377049,5.016752061882584,55.14718236434693
22,3,91,8,4,44,147,54.09836065573771,4.443833853657711,61.457805490604585
1,1,70,63,64,58,255,71.80327868852459,5.429025108797668,42.76769620267774
16,6,31,32,16,55,134,51.9672131147541,5.851598462863227,62.18118842238267
19,3,10,51,21,47,129,51.14754098360656,3.0661984460468723,65.78626057034657
23,5,9,88,97,26,220,66.0655737704918,5.947563816768116,47.986862412740095
11,3,72,13,40,52,177,59.01639344262295,3.258396417191041,57.72521014018601
17,2,77,74,92,86,329,83.9344262295082,5.443160337806284,30.622413432685505
2,1,76,52,67,87,282,76.22950819672131,3.8410042576542374,39.929487545624454
0,2,56,98,68,72,294,78.19672131147541,3.3965389732616154,38.40673971526297
0,2,24,58,10,34,126,50.65573770491803,4.319566919141504,65.02469537594047
18,5,1,77,55,50,183,60.0,4.93186973834284,55.06813026165716
10,1,63,93,50,83,289,77.37704918032787,4.142855535070425,38.4800952846017
4,1,34,40,20,36,130,51.31147540983606,3.163696224848097,65.52482836531584
11,1,6,67,98,80,251,71.14754098360655,4.79838341897615,44.05407559741731
2,1,84,67,75,94,320,82.45901639344262,5.707209828332024,31.83377377822535
0,1,17,91,25,56,189,60.98360655737705,4.149646097841755,54.86674734478119
0,5,66,7,18,7,98,46.06557377049181,3.6489983328924813,70.28542789661572
7,3,41,1,59,78,179,59.34426229508197,4.327732037798446,56.328005667119584
9,2,38,85,70,94,287,77.04918032786885,3.1450881331463427,39.8057315389848
10,1,40,40,46,93,219,65.90163934426229,5.461462753440824,48.63689790229688
11,7,74,54,70,19,217,65.57377049180329,5.47902243285056,48.94720707534616
12,3,23,15,25,52,115,48.85245901639344,4.764001390288885,66.38353959331768
11,3,59,92,39,11,201,62.95081967213115,4.059308666815168,52.989871661053684
13,2,45,61,4,48,158,55.90163934426229,5.39935009333735,58.69901056240036
1,5,18,47,20,16,101,46.557377049180324,4.664061074365101,68.77856187645457
18,4,67,29,77,63,236,68.68852459016394,5.477796925650049,45.83367848418601
17,4,89,11,3,41,144,53.60655737704918,4.894376377749062,61.49906624520176
2,3,41,34,22,93,190,61.14754098360656,5.353216419638391,53.49924259675505
22,6,31,10,83,28,152,54.91803278688525,4.79568897965328,60.28627823346147
16,6,38,63,14,18,133,51.80327868852459,4.2424232046469985,63.95429810682841
7,2,35,49,92,10,186,60.49180327868852,5.873837579778413,53.63435914153307
9,4,96,84,7,97,284,76.55737704918033,4.623341474636534,38.819281476183136
1,3,35,20,40,49,144,53.60655737704918,4.815268555621615,61.57817406732921
18,5,2,68,18,70,158,55.90163934426229,3.661462918244248,60.43689773749346
8,4,72,47,45,57,221,66.22950819672131,4.876952368281829,48.89353943499685
6,3,7,19,27,33,86,44.09836065573771,4.714822948448831,71.18681639581345
3,3,96,66,90,19,271,74.42622950819673,3.554515193841075,42.019255297962204
20,1,69,43,67,49,228,67.37704918032787,3.178761292059431,49.44418952761269
17,5,40,32,14,87,173,58.36065573770492,4.813077959144313,56.82626630315077
12,1,67,72,98,9,246,70.327868852459,5.291076808050962,44.381054339490035
10,2,12,60,36,31,139,52.78688524590164,4.5702041127660245,62.642910641332335
23,1,48,8,0,51,107,47.540983606557376,3.680317875958937,68.77869851748369
3,7,59,67,66,14,206,63.77049180327869,4.999565930079105,51.22994226664221
20,1,1,34,23,83,141,53.114754098360656,3.2403171798288066,63.64492872181054
3,7,59,80,26,2,167,57.37704918032787,4.3255011144058635,58.29744970526626
9,4,4,97,39,36,176,58.85245901639344,3.4901002751952603,57.6574407084113
4,6,43,87,62,39,231,67.8688524590164,3.55337715317965,48.57777038780395
8,3,26,95,60,71,252,71.31147540983606,3.606881847474611,45.081642742689326
23,7,31,64,35,39,169,57.704918032786885,4.160121171131934,58.13496079608118
2,5,20,7,97,55,179,59.34426229508197,3.1534506168611927,57.50228708805684
16,1,7,44,92,22,165,57.049180327868854,4.193380322787295,58.757439349343855
2,7,71,86,23,10,190,61.14754098360656,4.535122341344103,54.31733667504933
15,5,49,46,23,63,181,59.67213114754098,4.449882854898975,55.877985997560046
3,6,66,39,3,7,115,48.85245901639344,4.148352301209122,66.99918868239743
17,6,43,75,66,92,276,75.24590163934425,5.517439824212257,39.236658536443485
16,1,57,53,33,93,236,68.68852459016394,3.4359800772615126,47.875495332574545
6,2,2,75,56,55,188,60.81967213114754,4.517090231344122,54.66323763750833
23,1,85,45,48,59,237,68.85245901639345,3.1861242508696628,47.96141673273688
22,4,69,46,86,9,210,64.42622950819671,3.2134670366337295,52.36030345516956
4,7,1,14,52,38,105,47.213114754098356,4.721597549031289,68.06528769687036
11,3,86,18,22,27,153,55.08196721311475,4.698055274663463,60.21997751222179
16,2,43,25,68,48,184,60.16393442622951,5.634100538533371,54.20196503523712
22,1,1,51,94,35,181,59.67213114754098,4.67362102698022,55.654247825478805
12,5,80,92,52,12,236,68.68852459016394,5.879373061214551,45.43210234862151
22,2,34,21,61,95,211,64.59016393442623,3.1460845451997894,52.26375152037399
2,7,97,20,40,35,192,61.47540983606558,3.2940230543422233,55.2305671095922
8,2,86,50,56,25,217,65.57377049180329,3.132197584711144,51.29403192348556
16,7,29,37,59,85,210,64.42622950819671,3.55583055100062,52.01793994080266
16,1,7,19,53,3,82,43.44262295081967,4.623810332825034,71.9335667163553
19,7,21,28,69,94,212,64.75409836065575,4.936716544282284,50.30918509506196
15,2,43,50,56,81,230,67.70491803278688,3.1367554738460064,49.15832649336711
21,5,57,3,9,63,132,51.63934426229508,5.837912669536798,62.52274306816812
12,6,35,54,39,37,165,57.049180327868854,5.526496129951143,57.424323542180005
18,2,68,70,6,87,231,67.8688524590164,3.8898374464712795,48.24131009451233
16,7,76,91,37,86,290,77.54098360655738,3.231562590679404,39.22745380276322
3,6,92,27,84,21,224,66.72131147540983,3.509661219657172,49.76902730493299
11,7,30,3,60,1,94,45.40983606557377,3.3808332412649182,71.20933069316132
8,5,46,21,83,30,180,59.50819672131148,3.3698513378968404,57.12195194079168
18,7,54,75,2,10,141,53.114754098360656,4.555685065997202,62.32956083564214
11,1,79,44,50,91,264,73.27868852459017,3.7375423274802007,42.983769147929635
8,3,61,66,85,45,257,72.1311475409836,4.074419149587433,43.79443330942897
6,2,29,85,46,95,255,71.80327868852459,5.968516000152968,42.22820531132244
13,3,54,65,67,61,247,70.49180327868852,5.052942746776035,44.45525397453544
19,7,15,87,91,68,261,72.78688524590164,5.846942001141004,41.366172752957354
18,5,11,33,75,63,182,59.83606557377049,3.427669665099347,56.736264761130165
14,2,16,90,37,9,152,54.91803278688525,4.146418424497708,60.93554878861704
15,7,15,54,35,39,143,53.44262295081967,4.664195409847062,61.89318163933327
20,6,11,0,40,23,74,42.131147540983605,3.230274185666214,74.63857827335019
4,4,7,71,68,98,244,70.0,3.0125623308838736,46.98743766911613
2,7,83,86,12,43,224,66.72131147540983,5.011303001390752,48.26738552319941
11,3,2,37,86,59,184,60.16393442622951,4.925458550404306,54.91060702336618
19,2,15,5,57,61,138,52.62295081967213,4.2323664299988355,63.14468275032904
20,3,29,85,49,86,249,70.81967213114754,4.468932228096098,44.711395640756365
3,2,22,24,29,16,91,44.91803278688525,4.246329001776269,70.83563821133848
20,7,91,81,61,64,297,78.68852459016394,3.0720151345346665,38.2394602753014
22,1,4,16,24,94,138,52.62295081967213,4.006114818652387,63.37093436167549
15,6,83,60,26,94,263,73.11475409836066,3.5312467661918694,43.35399913544747
6,7,64,11,50,56,181,59.67213114754098,3.295272567304106,57.032596285154916
12,3,29,5,77,54,165,57.049180327868854,5.870161301668049,57.0806583704631
20,4,20,89,56,52,217,65.57377049180329,4.798079175126497,49.62815033307021
9,4,83,26,46,55,210,64.42622950819671,5.185968852709808,50.38780163909348
6,5,69,7,99,97,272,74.59016393442623,3.9460912297983524,41.463744835775415
13,2,21,82,38,8,149,54.42622950819673,4.179441388482045,61.394329103321226
4,3,81,64,15,21,181,59.67213114754098,3.7107719816901703,56.61709687076885
2,5,71,56,21,12,160,56.22950819672131,3.2908970128962745,60.479594790382414
22,3,31,92,84,88,295,78.36065573770492,3.5370949123247515,38.102249349970336
10,2,32,98,53,47,230,67.70491803278688,5.392542135889458,46.902539831323665
10,7,15,39,20,17,91,44.91803278688525,5.032637415551328,70.04932979756342
17,7,75,13,71,75,234,68.36065573770492,4.64078662795643,46.99855763433865
14,4,37,34,15,39,125,50.49180327868852,4.425269618600304,65.08292710271118
11,7,97,47,58,16,218,65.73770491803279,5.767302850968374,48.49499223099883
8,7,13,83,30,14,140,52.950819672131146,3.218204843336005,63.83097548453285
9,1,35,55,41,14,145,53.77049180327869,3.841802439713748,62.387705757007566
11,4,96,48,73,78,295,78.36065573770492,4.049813560712142,37.589530701582945
16,5,22,12,31,62,127,50.81967213114754,5.347277436638364,63.833050432214094
5,6,65,60,58,38,221,66.22950819672131,5.977543860485914,47.79294794279278
6,1,84,48,33,12,177,59.01639344262295,3.722011544271459,57.26159501310559
13,5,1,45,8,80,134,51.9672131147541,5.622922002411242,62.409864882834654
12,2,90,61,80,31,262,72.95081967213115,5.491868281295374,41.557312046573486
7,1,72,7,10,8,97,45.90163934426229,3.6739721929252998,70.4243884628124
9,5,64,42,95,39,240,69.34426229508196,4.197997740597668,46.45773996432037
8,2,74,19,9,19,121,49.83606557377049,4.229018607877557,65.93491581835195
17,4,66,96,85,89,336,85.08196721311475,5.934662005579675,28.98337078130558
1,6,51,89,16,90,246,70.327868852459,3.5426757041366947,46.1294554434043
4,2,61,38,67,84,250,70.98360655737704,5.397473913314347,43.61891952930861
4,7,22,84,47,81,234,68.36065573770492,4.002578142519329,47.63676611977576
5,3,25,48,51,76,200,62.786885245901644,5.192611037328481,52.02050371676988
18,2,67,63,24,79,233,68.19672131147541,4.260033012886988,47.54324567563759
7,2,81,61,20,72,234,68.36065573770492,4.7350792893496205,46.90426497294547
15,6,54,53,64,62,233,68.19672131147541,5.497835319978393,46.30544336854619
12,3,5,8,62,75,150,54.59016393442623,5.412496694951653,59.997339370622115
0,7,34,87,88,43,252,71.31147540983606,5.5992695506191,43.08925503954484
21,5,21,36,50,37,144,53.60655737704918,3.178851976033977,63.21459064691685
19,5,42,48,35,82,207,63.9344262295082,5.076151659119235,50.98942211137256
16,2,14,40,80,59,193,61.63934426229508,3.4199621301652887,54.94069360753963
6,3,85,16,87,70,258,72.29508196721312,4.247455704055233,43.45746232873165
12,3,59,87,65,98,309,80.65573770491804,4.645765245164066,34.69849704991789
3,7,11,20,14,47,92,45.08196721311475,4.208218454240493,70.70981433264475
3,6,48,50,95,17,210,64.42622950819671,4.558835027409023,51.01493546439427
5,4,41,58,38,15,152,54.91803278688525,5.989578926395858,59.092388286718894
18,5,37,38,69,54,198,62.459016393442624,3.405651941138564,54.13533166541882
11,6,81,54,0,38,173,58.36065573770492,5.0263681360092765,56.61297612628581
21,1,44,40,22,67,173,58.36065573770492,4.188002899156846,57.45134136313824
6,5,34,38,38,58,168,57.540983606557376,3.3990293967219865,59.05998699672064
9,6,29,12,56,88,185,60.32786885245902,3.4762102901229284,56.19592085741805
18,5,87,63,80,95,325,83.27868852459017,5.847819318736851,30.87349215667298
6,4,29,10,33,61,133,51.80327868852459,5.638804490135286,62.55791682134012
2,1,77,18,40,12,147,54.09836065573771,5.721125881245065,60.18051346301723
12,4,5,10,92,80,187,60.65573770491803,5.974598327482159,53.369663967599806
12,7,66,76,72,5,219,65.90163934426229,3.624946170025554,50.473414485712155
17,1,79,45,12,82,218,65.73770491803279,4.066318012092186,50.19597706987503
19,2,6,44,69,76,195,61.9672131147541,5.0076570897746,53.0251297954713
7,6,51,0,5,59,115,48.85245901639344,4.451407619581942,66.69613336402462
8,1,13,39,83,89,224,66.72131147540983,4.255168600135001,49.02351992445517
6,7,72,18,51,13,154,55.24590163934427,4.07343374800678,60.680664612648954
0,7,14,75,2,94,185,60.32786885245902,4.781341895830357,54.89078925171063
2,4,20,71,80,53,224,66.72131147540983,4.7267802859202455,48.551908238669924
12,5,34,71,62,3,170,57.868852459016395,3.48437350219272,58.64677403879089
16,1,65,60,48,38,211,64.59016393442623,4.415219512555318,50.99461655301846
23,6,90,11,75,71,247,70.49180327868852,4.66041532862955,44.847781392681924
0,1,1,60,46,24,131,51.47540983606557,4.710860816194171,63.81372934774026
5,3,34,32,54,76,196,62.13114754098361,3.6303215787370555,54.23853088027933
20,5,81,44,63,31,219,65.90163934426229,5.226814176756861,48.87154647898085
5,6,77,89,64,58,288,77.21311475409836,3.0755972844632087,39.71128796143843
11,6,19,91,80,62,252,71.31147540983606,4.064495566629488,44.62402902353445
12,2,81,68,66,37,252,71.31147540983606,5.3406379456069,43.347886644557036
12,4,9,7,89,91,196,62.13114754098361,4.691678763166207,53.177173695850186
14,2,24,24,14,52,114,48.68852459016394,3.783487297532581,67.52798811230349
20,6,65,90,99,93,347,86.88524590163935,5.084859358029143,28.0298947403315
15,5,24,45,31,66,166,57.213114754098356,4.70217283246822,58.08471241343342
21,1,53,86,95,27,261,72.78688524590164,5.3887308283691615,41.824383925729194
20,1,32,29,67,2,130,51.31147540983606,5.205075558569471,63.48344903159447
10,5,35,46,17,97,195,61.9672131147541,4.8303237661087035,53.20246311913719
4,6,94,86,82,79,341,85.90163934426229,4.464533025932442,29.633827629805268
3,7,13,48,42,21,124,50.32786885245902,3.3995463770025705,66.2725847705384
2,1,64,46,34,95,239,69.18032786885246,3.783999053656151,47.035673077491396
18,7,79,83,77,37,276,75.24590163934425,4.257298418751256,40.496799941904484
19,1,53,81,57,71,262,72.95081967213115,4.797897861019166,42.25128246684969
17,1,51,17,32,71,171,58.0327868852459,4.541123565645915,57.426089549108184
14,4,2,65,13,61,141,53.114754098360656,3.8645535778785884,63.020692323760755
8,4,98,67,33,56,254,71.63934426229508,3.0193930733691317,45.34126266433579
16,3,40,93,60,5,198,62.459016393442624,4.488717665702442,53.05226594085494
13,2,5,32,3,77,117,49.18032786885246,3.856877965686729,66.96279416546082
14,5,24,35,87,31,177,59.01639344262295,5.203824902131605,55.77978165524544
0,5,12,81,58,98,249,70.81967213114754,3.0718387958114506,46.108489073041014
20,5,97,18,28,9,152,54.91803278688525,4.754483433917373,60.32748377919738
21,3,7,27,82,2,118,49.34426229508197,5.824422712518196,64.83131499239984
21,4,20,39,5,58,122,50.0,3.5232278013344986,66.4767721986655
2,6,97,83,96,75,351,87.54098360655738,4.414948472251786,28.044067921190845
15,7,67,96,48,48,259,72.45901639344262,3.2742659754514145,44.26671763110596
22,7,24,75,39,58,196,62.13114754098361,4.877045736784058,52.991806722232326
10,6,78,14,82,30,204,63.44262295081967,4.651595041788677,51.90578200739165
11,3,67,40,64,92,263,73.11475409836066,4.222096572638497,42.663149329000845
9,6,44,38,68,68,218,65.73770491803279,4.564131064421224,49.69816401754599
15,5,59,1,26,61,147,54.09836065573771,5.689723975407031,60.21191536885526
7,2,11,62,79,51,203,63.27868852459016,3.5888829069332013,53.13242856847664
5,1,31,28,5,88,152,54.91803278688525,3.0676935351160415,62.01427367799871
11,7,95,73,12,40,220,66.0655737704918,5.584994654097303,48.349431575410904
23,4,91,65,63,30,249,70.81967213114754,4.731351247163719,44.44897662168874
20,4,12,50,61,84,207,63.9344262295082,5.671975366385527,50.39359840410627
7,3,30,74,98,83,285,76.72131147540983,4.790835670239518,38.48785285435065
3,4,77,76,18,21,192,61.47540983606558,5.430483269879107,53.094106894055315
7,5,19,9,75,3,106,47.37704918032787,4.289020090065444,68.33393072960669
17,7,17,13,79,12,121,49.83606557377049,5.2495797938648066,64.9143546323647
4,6,92,81,42,44,259,72.45901639344262,5.739124400669568,41.80185920588781
8,5,59,50,73,41,223,66.55737704918033,4.716368891166619,48.726254059653044
3,3,62,72,88,48,270,74.26229508196721,3.5423554516871385,42.19534946634565
21,5,5,38,19,19,81,43.278688524590166,3.8063928450905946,72.91491863031925
16,6,31,27,94,76,228,67.37704918032787,3.5959337306922174,49.0270170889799
8,2,92,2,67,80,241,69.50819672131146,3.7405710827871985,46.75123219590134
0,3,42,83,43,53,221,66.22950819672131,3.9192463480531092,49.85124545522558
20,2,1,69,22,35,127,50.81967213114754,4.665401360259565,64.5149265085929
19,1,59,26,1,96,182,59.83606557377049,4.763974888391498,55.399959537838015
12,2,22,1,21,0,44,37.21311475409836,4.279499241725583,78.50738600417606
15,1,82,92,56,14,244,70.0,4.846262339462506,45.15373766053749
12,1,30,37,71,76,214,65.08196721311475,3.2447247768340977,51.673308010051144
13,2,4,2,6,16,28,34.59016393442623,3.26336471117448,82.1464713543993
2,3,82,15,77,23,197,62.295081967213115,3.5154883810729753,54.18942965171391
5,6,33,93,55,57,238,69.01639344262296,4.554232494121035,46.429374063256006
17,5,9,39,66,71,185,60.32786885245902,3.6419840360949407,56.03014711144604
18,5,88,1,15,90,194,61.80327868852459,3.849853210477732,54.34686810099768
4,6,1,80,82,22,185,60.32786885245902,4.200938508518982,55.47119263902199
14,7,10,40,50,45,145,53.77049180327869,5.435598372031139,60.793909824690175
1,7,49,11,81,71,212,64.75409836065575,3.0415864077385804,52.204315231605676
9,1,30,34,79,7,150,54.59016393442623,4.9481364607098675,60.4616996048639
23,1,55,64,71,58,248,70.65573770491804,5.006629593122057,44.337632701959905
17,3,78,54,96,89,317,81.96721311475409,5.39596734106991,32.63681954417601
12,4,72,44,11,58,185,60.32786885245902,5.7982588171809395,53.873872330360044
4,2,86,78,52,12,228,67.37704918032787,3.0604135468478697,49.56253727282426
22,1,82,89,74,38,283,76.39344262295081,3.4613511165396487,40.14520626050954
23,5,8,84,4,27,123,50.1639344262295,5.658513882167979,64.17755169160252
0,3,98,61,26,88,273,74.75409836065575,4.3755556865610465,40.87034595278321
21,2,20,48,11,60,139,52.78688524590164,4.69377191680039,62.51934283729797
0,3,72,94,16,15,197,62.295081967213115,4.989081611169443,52.71583642161744
17,2,27,24,5,1,57,39.34426229508197,5.037199813486913,75.61853789143112
14,2,61,22,96,81,260,72.62295081967213,5.795221209949524,41.581827970378356
16,6,6,23,4,16,49,38.032786885245905,5.9908482522350095,75.97636486251909
10,1,79,37,56,29,201,62.95081967213115,5.160472382792821,51.88870794507602
20,3,15,27,27,12,81,43.278688524590166,3.8616636276154526,72.85964784779438
21,3,96,20,77,95,288,77.21311475409836,5.6392572068830304,37.14762803901861
16,6,3,53,68,92,216,65.40983606557377,3.147662743622285,51.44250119080394
12,5,3,17,58,93,171,58.0327868852459,3.6932425586234885,58.273970556130614
0,5,39,35,32,81,187,60.65573770491803,5.692157152391145,53.65210514269083
1,7,16,98,61,12,187,60.65573770491803,3.768574543318065,55.57568775176391
8,1,51,44,49,42,186,60.49180327868852,3.6619531788652453,55.84624354244623
2,1,92,72,18,84,266,73.60655737704919,3.4143758794207417,42.97906674353007
0,4,51,52,85,93,281,76.0655737704918,5.57733527294075,38.35709095656746
20,6,35,29,68,20,152,54.91803278688525,4.50017477757326,60.58179243554149
15,5,37,59,65,54,215,65.24590163934425,5.024679609162464,49.729418751493284
22,2,49,97,93,80,319,82.29508196721312,3.717199152225089,33.987718880561786
5,3,62,31,46,39,178,59.18032786885246,5.274121263033649,55.54555086811389
16,1,62,66,38,82,248,70.65573770491804,5.280016634886295,44.06424566019567
4,3,61,66,67,14,208,64.09836065573771,3.9377940747249003,51.96384526953739
4,3,98,27,32,72,229,67.54098360655738,4.2320478990308485,48.22696849441178
5,4,6,43,12,51,112,48.36065573770492,3.6290708322906027,68.01027343000447
2,5,26,78,83,73,260,72.62295081967213,5.929683069968712,41.447366110359155
20,1,91,40,53,94,278,75.57377049180327,4.936807731175235,39.48942177702149
22,3,85,62,6,52,205,63.60655737704918,5.803631642146547,50.58981098080427
4,1,13,22,78,86,199,62.622950819672134,3.9101566308873994,53.46689254944047
20,2,70,74,86,51,281,76.0655737704918,5.345672738990669,38.58875349051753
4,4,85,47,13,29,174,58.52459016393442,5.297575931654226,56.17783390441136
9,2,4,31,86,32,153,55.08196721311475,5.074966955599624,59.84306583128563
9,1,54,56,18,56,184,60.16393442622951,5.896916925800401,53.939148647970086
18,7,1,99,53,51,204,63.44262295081967,4.180666008318947,52.37671104086138
16,1,61,32,92,8,193,61.63934426229508,3.3921519707692718,54.96850376693564
20,5,90,23,19,53,185,60.32786885245902,5.0151265777321825,54.657004569808805
13,3,20,38,28,0,86,44.09836065573771,5.187929401431619,70.71370994283068
8,3,78,33,23,43,177,59.01639344262295,4.725181720376444,56.258424837000604
13,2,20,55,81,98,254,71.63934426229508,3.620453679400189,44.74020205830473
0,4,9,27,62,74,172,58.196721311475414,4.513367825008066,57.28991086351652
18,7,86,36,73,97,292,77.8688524590164,3.9365692097073883,38.19457833127622
12,6,57,6,56,79,198,62.459016393442624,4.282399584500068,53.258584022057306
12,3,38,67,7,8,120,49.67213114754098,4.935655727533992,65.39221312492504
3,5,4,36,89,31,160,56.22950819672131,5.235644228072504,58.534847575206186
0,2,64,55,61,14,194,61.80327868852459,3.6966740727040293,54.50004723877137
16,2,12,64,28,11,115,48.85245901639344,4.21597608194086,66.9315649016657
7,6,84,64,73,96,317,81.96721311475409,3.8074847129748877,34.22530217227103
1,5,89,46,16,77,228,67.37704918032787,3.5958948415856073,49.02705597808652
7,4,84,19,65,56,224,66.72131147540983,5.350161659987515,47.928526864602645
6,5,52,18,5,7,82,43.44262295081967,5.727758083310977,70.82961896586936
1,4,81,28,57,71,237,68.85245901639345,4.11069655705373,47.03684442655282
21,5,44,73,68,26,211,64.59016393442623,5.2538367731213,50.155999292452464
21,5,31,59,27,61,178,59.18032786885246,5.690985868093233,55.128686263054306
2,1,35,17,61,11,124,50.32786885245902,5.538372631590695,64.13375851595029
17,2,80,91,40,64,275,75.08196721311475,3.5484401656176776,41.36959262126757
11,5,98,34,68,41,241,69.50819672131146,5.8688756445400845,44.62292763414845
0,6,59,42,81,61,243,69.8360655737705,4.130029321288387,46.03390510494111
21,5,10,94,89,10,203,63.27868852459016,4.017721983521509,52.70358949188834
11,3,62,90,83,42,277,75.40983606557377,3.1872939818333412,41.402869952592894
4,2,20,10,40,94,164,56.885245901639344,4.458520962314649,58.656233136046005
16,3,51,48,48,16,163,56.721311475409834,3.3270408469227863,59.95164767766738
15,2,54,37,90,96,277,75.40983606557377,3.745619462782278,40.84454447164396
14,3,25,63,48,31,167,57.37704918032787,3.9508278653018443,58.67212295437028
22,5,67,68,75,92,302,79.50819672131148,5.426478970475053,35.06532430821346
14,5,33,7,70,84,194,61.80327868852459,5.62646595118769,52.57025536028772
4,1,51,33,2,84,170,57.868852459016395,3.9073989523844093,58.22374858859919
20,6,81,47,9,39,176,58.85245901639344,5.576094363733722,55.571446619872845
13,3,98,55,97,22,272,74.59016393442623,5.571692812109373,39.838143253464395
1,4,92,75,88,55,310,80.81967213114754,5.2939528511546206,33.886375017697844
10,1,51,64,34,5,154,55.24590163934427,3.4400853420455446,61.31401301861019
18,3,28,30,79,85,222,66.39344262295083,5.070968540702187,48.53558883634699
6,3,37,3,1,49,90,44.75409836065574,5.8350721937417065,69.41082944560256
5,1,41,49,23,36,149,54.42622950819673,5.047621436301471,60.526149055501804
1,5,20,68,73,63,224,66.72131147540983,3.9948505473235016,49.28383797726667
5,3,41,29,37,53,160,56.22950819672131,4.501737952292494,59.268753850986194
17,5,12,87,21,71,191,61.31147540983606,4.937175130053161,53.751349460110774
1,1,63,58,25,48,194,61.80327868852459,4.531711226185511,53.66501008528989
17,5,16,66,42,98,222,66.39344262295083,3.3598588251929096,50.246698551856255
14,2,8,74,54,10,146,53.9344262295082,3.936192133956062,62.12938163653574
18,4,40,44,38,87,209,64.26229508196721,5.407188091660897,50.33051682637189
1,7,0,3,90,48,141,53.114754098360656,5.5842541382865525,61.30099176335279
19,3,1,25,28,20,74,42.131147540983605,3.4119000981467105,74.45695236086968
5,6,59,26,19,65,169,57.704918032786885,5.857160257196174,56.43792171001694
0,4,47,45,90,62,244,70.0,3.986467853545828,46.01353214645417
23,7,28,63,40,82,213,64.91803278688525,4.98694121619216,50.09502599692259
14,5,96,90,53,27,266,73.60655737704919,5.255475437870043,41.13796718508077
22,3,9,50,19,16,94,45.40983606557377,5.43583870391365,69.15432523051257
9,5,57,49,18,5,129,51.14754098360656,5.83724910667779,63.01520990971565
18,2,59,5,83,18,165,57.049180327868854,3.9387586440864677,59.01206102804468
16,1,20,58,98,55,231,67.8688524590164,5.575519363654664,46.55562817732894
4,3,27,14,65,27,133,51.80327868852459,3.395060710308621,64.80166060116679
3,7,74,29,29,65,197,62.295081967213115,5.115122719060778,52.589795313726114
9,7,33,41,52,37,163,56.721311475409834,5.2259331885419575,58.05275533604821
23,2,7,36,33,36,112,48.36065573770492,5.033169723603962,66.60617453869112
16,2,58,41,21,67,187,60.65573770491803,3.756944208405459,55.587318086676504
9,3,85,34,66,85,270,74.26229508196721,5.61912944104561,40.118575476987175
16,5,71,86,5,89,251,71.14754098360655,3.506575390111185,45.34588362628227
19,6,48,5,78,48,179,59.34426229508197,3.1609043745624925,57.49483333035554
23,7,78,67,26,42,213,64.91803278688525,5.1523949718357365,49.92957224127902
4,7,16,17,9,35,77,42.622950819672134,4.4264271456982005,72.95062203462967
1,2,59,72,72,57,260,72.62295081967213,5.5472940598760285,41.82975512045185
5,4,86,28,96,12,222,66.39344262295083,4.1501914231747765,49.456365953874396
20,2,87,76,95,51,309,80.65573770491804,3.5048357655231386,35.83942652955882
1,6,44,58,47,57,206,63.77049180327869,5.50932657740961,50.7201816193117
12,5,82,46,69,31,228,67.37704918032787,4.646728894920215,47.97622192475191
10,5,68,16,58,80,222,66.39344262295083,3.5675873771710647,50.038969999878105
10,4,31,95,99,99,324,83.11475409836066,5.1611519957593375,31.724093905879997
15,7,43,21,58,59,181,59.67213114754098,4.533340915468502,55.79452793699052
10,2,64,67,1,82,214,65.08196721311475,4.812938946720959,50.10509384016429
18,5,86,68,28,57,239,69.18032786885246,4.382695014619745,46.4369771165278
14,6,7,36,67,98,208,64.09836065573771,5.486126951454019,50.41551239280827
22,3,76,48,64,55,243,69.8360655737705,5.4886881470491495,44.67524627918036
22,1,71,12,82,27,192,61.47540983606558,5.128166465473159,53.39642369846126
15,1,86,33,25,0,144,53.60655737704918,3.316204132189387,63.07723849076144
10,1,42,85,88,41,256,71.96721311475409,5.516561585712207,42.5162252995337
21,7,0,52,9,81,142,53.278688524590166,5.0130389415987295,61.708272533811105
15,2,50,86,52,47,235,68.52459016393442,5.091072498012899,46.38433733805269
7,4,23,50,78,39,190,61.14754098360656,4.088948521211615,54.76351049518182
3,5,98,2,58,96,254,71.63934426229508,5.63783866847102,42.7228170692339
7,3,23,41,21,62,147,54.09836065573771,5.176114800704573,60.72552454355772
3,6,16,97,50,75,238,69.01639344262296,3.3377713995875835,47.64583515778946
23,3,4,31,47,71,153,55.08196721311475,4.2233341032184875,60.69469868366676
2,6,19,50,20,87,176,58.85245901639344,5.6591410858804245,55.48839989772614
2,7,20,84,21,79,204,63.44262295081967,3.141590105092137,53.4157869440882
17,2,57,45,99,3,204,63.44262295081967,5.8842498589261485,50.67312719025418
18,1,30,20,97,37,184,60.16393442622951,5.037487704958688,54.798577868811805
18,2,99,43,29,26,197,62.295081967213115,4.89412793293013,52.81079009985676
20,7,10,10,24,8,52,38.52459016393443,3.8116777694639743,77.6637320666016
4,4,51,67,27,15,160,56.22950819672131,3.7463753662175314,60.02411643706115
17,4,14,0,64,55,133,51.80327868852459,5.826174658465787,62.37054665300962
9,7,82,91,44,75,292,77.8688524590164,3.8948173627023683,38.236330178281236
21,6,6,62,67,30,165,57.049180327868854,5.326515890156998,57.62430378197415
20,5,27,23,6,87,143,53.44262295081967,4.179365394621238,62.378011654559096
5,5,50,98,48,13,209,64.26229508196721,3.417762212354112,52.319942705678685
0,6,57,12,8,24,101,46.557377049180324,3.032145893086077,70.4104770577336
4,4,4,97,35,33,169,57.704918032786885,4.632772011045752,57.66230995616736
8,4,4,10,82,66,162,56.55737704918033,5.927336455646798,57.51528649517287
11,4,93,99,0,23,215,65.24590163934425,4.107408581427613,50.646689779228126
13,2,95,50,9,72,226,67.04918032786885,4.071577001979135,48.87924267015201
1,4,7,16,35,25,83,43.60655737704918,4.032274853548326,72.3611677694025
16,3,63,98,72,19,252,71.31147540983606,4.561631511914575,44.12689307824937
13,1,9,81,45,63,198,62.459016393442624,4.321994650272881,53.21898895628449
12,4,37,85,31,9,162,56.55737704918033,5.639743880181044,57.802879070638625
8,6,95,23,31,82,231,67.8688524590164,4.516562375170471,47.61458516581314
14,1,91,18,5,66,180,59.50819672131148,4.523273514565706,55.96852976412282
21,2,80,36,47,23,186,60.49180327868852,3.41511478416167,56.093081937149805
14,6,94,84,37,4,219,65.90163934426229,5.948218622731158,48.150142033006546
23,1,7,7,16,66,96,45.73770491803279,3.749918672606489,70.51237640936071
10,6,24,27,73,57,181,59.67213114754098,3.220092202378808,57.10777665008021
15,2,72,4,26,26,128,50.983606557377044,4.989438746925627,64.02695469569733
16,3,65,16,53,79,213,64.91803278688525,4.786099110470618,50.295868102644135
3,2,78,35,49,14,176,58.85245901639344,4.245436961978237,56.902104021628325
0,2,49,18,34,34,135,52.131147540983605,4.266576701642034,63.60227575737436
7,6,66,63,84,75,288,77.21311475409836,5.355191763139294,37.431693482762356
16,7,48,90,24,52,214,65.08196721311475,3.587137920298947,51.330894866586306
2,5,35,97,27,43,202,63.11475409836065,5.46075995683467,51.42448594480469
19,4,67,10,14,25,116,49.016393442622956,4.946241341685054,66.03736521569199
14,4,77,53,3,46,179,59.34426229508197,4.256909321338573,56.398828383579456
14,3,40,44,92,33,209,64.26229508196721,4.374085849751606,51.36361906828118
23,3,88,46,72,86,292,77.8688524590164,3.7699416215582873,38.361205919425316
21,4,61,11,26,94,192,61.47540983606558,5.256342998090925,53.26824716584349
13,5,9,20,25,49,103,46.885245901639344,4.538624226915803,68.57612987144486
22,4,20,10,18,83,131,51.47540983606557,3.962563628249531,64.5620265356849
13,7,35,91,91,11,228,67.37704918032787,4.788150347282851,47.834800472389276
23,5,11,4,16,86,117,49.18032786885246,5.9872033561539695,64.83246877499357
1,3,90,80,42,3,215,65.24590163934425,4.305786838969661,50.44831152168608
12,1,1,55,40,86,182,59.83606557377049,5.762074202335858,54.40186022389365
13,6,12,19,41,47,119,49.50819672131148,4.035050519773698,66.45675275891483
23,7,52,40,49,54,195,61.9672131147541,3.164198120774958,54.86858876447094
18,7,31,45,83,0,159,56.0655737704918,3.6127263191052865,60.32169991040291
6,3,94,11,39,88,232,68.03278688524591,4.256085429983052,47.71112768477104
2,3,15,69,38,65,187,60.65573770491803,3.658904785783707,55.68535750929826
14,2,31,16,22,29,98,46.06557377049181,3.0006811146547667,70.93374511485342
22,7,31,18,95,2,146,53.9344262295082,5.745004613242582,60.320569157249224
13,2,97,25,51,20,193,61.63934426229508,5.531638233692787,52.82901750401213
10,2,10,47,46,88,191,61.31147540983606,5.226876694460842,53.461647895703095
14,6,9,51,62,83,205,63.60655737704918,3.503443786938086,52.88999883601274
12,2,14,95,96,48,253,71.47540983606558,3.361090728629958,45.16349943530446
17,5,16,69,68,85,238,69.01639344262296,3.2028142484171496,47.78079230895989
5,4,39,54,42,84,219,65.90163934426229,5.172087566318764,48.92627308941894
2,1,17,99,47,61,224,66.72131147540983,5.786423882063656,47.49226464252651
18,3,54,74,33,96,257,72.1311475409836,4.291607462739111,43.57724499627729
14,5,72,32,39,37,180,59.50819672131148,3.3574220159881447,57.13438126270038
22,1,24,61,74,14,173,58.36065573770492,4.537178462196319,57.10216580009876
4,7,58,87,60,51,256,71.96721311475409,4.046495722375891,43.98629116287002
9,7,77,22,49,78,226,67.04918032786885,4.124474773049993,48.82634489908115
6,7,88,14,66,45,213,64.91803278688525,4.863991872467122,50.21797534064763
16,5,21,26,61,24,132,51.63934426229508,5.156154339786607,63.20450139791831
6,5,29,74,57,20,180,59.50819672131148,3.3318107966194823,57.15999248206904
21,3,83,63,32,87,265,73.44262295081967,3.1067706924194294,43.4506063567609
11,4,84,80,74,4,242,69.67213114754098,5.982990908057145,44.34487794440187
16,2,43,50,15,69,177,59.01639344262295,3.6981850467466555,57.28542151063039
12,7,31,52,81,46,210,64.42622950819671,3.1614915747253773,52.41227891707791
19,6,50,77,93,86,306,80.1639344262295,3.56962598728776,36.26643958648273
3,4,45,90,47,67,249,70.81967213114754,3.1168735390453928,46.06345432980707
9,6,20,81,9,90,200,62.786885245901644,4.175432683851515,53.037682070246845
2,3,98,91,81,17,287,77.04918032786885,5.407205353353973,37.54361431877717
8,3,31,50,37,20,138,52.62295081967213,4.0237333492731615,63.353315831054715
12,3,93,46,18,91,248,70.65573770491804,4.3325502206351,45.01171207444686
17,1,38,3,35,98,174,58.52459016393442,5.026760320702317,56.448649515363265
14,6,11,6,58,85,160,56.22950819672131,4.526682210209641,59.243809593069045
3,4,46,34,62,22,164,56.885245901639344,5.584337058063973,57.53041704029668
14,4,17,47,76,63,203,63.27868852459016,5.59810702513727,51.12320445027257
21,5,20,72,45,66,203,63.27868852459016,3.029732086473461,53.691579388936375
1,5,12,71,2,39,124,50.32786885245902,5.334138919449598,64.33799222809138
14,7,20,44,73,9,146,53.9344262295082,4.3822008007250215,61.68337296976678
7,5,7,80,64,88,239,69.18032786885246,5.966521623910989,44.85315050723655
7,3,45,80,90,51,266,73.60655737704919,4.449696227626306,41.94374639532451
16,4,6,96,7,71,180,59.50819672131148,5.960687836164892,54.53111544252363
11,6,22,95,50,74,241,69.50819672131146,5.26370808361721,45.22809519507132
18,3,95,71,80,60,306,80.1639344262295,3.745814653839919,36.09025091993058
9,1,74,18,72,63,227,67.21311475409837,4.615184937860873,48.171700308040755
8,5,85,62,5,4,156,55.57377049180327,5.976406918435748,58.44982258976098
4,3,21,37,88,52,198,62.459016393442624,5.572591823255771,51.9683917833016
5,3,88,66,38,54,246,70.327868852459,3.2921006813736633,46.38003046616733
19,1,21,58,59,36,174,58.52459016393442,5.119115990429988,56.35629384563559
1,2,91,68,27,55,241,69.50819672131146,4.036738757612439,46.455064521076096
23,4,28,12,96,58,194,61.80327868852459,3.020946785641044,55.175774525834356
12,6,12,46,53,92,203,63.27868852459016,4.210442907080999,52.510868568328846
5,7,81,60,36,68,245,70.1639344262295,3.704263265174914,46.13180230859558
4,2,1,30,8,72,111,48.196721311475414,5.4566078115614145,66.34667087696317
0,5,28,79,81,58,246,70.327868852459,4.0119918265372965,45.6601393210037
20,3,84,95,55,1,235,68.52459016393442,5.482571081861451,45.99283875420413
21,1,78,21,58,64,221,66.22950819672131,3.001793816504386,50.7686979867743
20,1,51,92,84,59,286,76.88524590163934,3.9234574500783577,39.191296648282304
5,4,26,85,1,50,162,56.55737704918033,3.723495642923286,59.719127307896386
5,2,49,42,60,29,180,59.50819672131148,3.700702083205833,56.79110119548269
22,7,94,66,57,10,227,67.21311475409837,3.204559859296388,49.58232538660525
15,4,78,53,59,91,281,76.0655737704918,3.561372811231505,40.3730534182767
3,3,22,9,39,75,145,53.77049180327869,4.66664870965686,61.56285948706445
10,4,87,41,35,38,201,62.95081967213115,3.8740832185132335,53.17509710935562
23,6,43,63,36,89,231,67.8688524590164,4.252184346987444,47.87896319399616
22,1,76,20,78,76,250,70.98360655737704,4.130600641041566,44.88579280158139
8,1,21,79,91,71,262,72.95081967213115,5.627714774999683,41.421465552869165
22,5,42,75,17,62,196,62.13114754098361,5.715896997031546,52.152955461984845
2,5,36,65,97,63,261,72.78688524590164,4.47887091496758,42.734243839130784
18,7,60,40,62,60,222,66.39344262295083,3.990467850946813,49.61608952610236
7,3,96,23,21,53,193,61.63934426229508,3.320402112007091,55.04025362569783
4,6,55,34,10,91,190,61.14754098360656,5.860208638146285,52.99225037824715
3,2,2,55,57,93,207,63.9344262295082,3.180680834700892,52.884892935790916
23,4,62,29,56,72,219,65.90163934426229,3.8929508327048414,50.205409823032866
5,7,18,56,76,94,244,70.0,3.8941986035100125,46.105801396489994
1,3,22,93,3,57,175,58.68852459016394,3.9612038584206446,57.35027155141542
19,5,28,46,85,84,243,69.8360655737705,3.4928605298172277,46.67107389641228
10,4,29,34,6,55,124,50.32786885245902,5.349484292771091,64.32264685476989
3,5,38,18,60,33,149,54.42622950819673,3.3674935858979675,62.206276905905305
14,4,24,7,53,30,114,48.68852459016394,4.9047199774594885,66.40675543237657
5,2,7,25,87,51,170,57.868852459016395,3.3715380801174524,58.75960946086615
21,3,57,70,67,88,282,76.22950819672131,3.2116069127788696,40.55888489049981
16,4,15,29,91,75,210,64.42622950819671,5.728288511057629,49.84548198074566
23,6,71,6,78,0,155,55.40983606557377,3.570386298956117,61.01977763547011
5,7,0,66,0,54,120,49.67213114754098,5.463750463679113,64.8641183887799
18,1,4,64,54,21,143,53.44262295081967,4.633892613321407,61.923484435858924
1,6,2,35,2,39,78,42.78688524590164,3.233569558826309,73.97954519527205
14,6,64,24,77,0,165,57.049180327868854,5.866344574314202,57.08447509781694
10,7,3,36,37,64,140,52.950819672131146,3.7408835009756776,63.30829682689318
7,1,98,0,0,62,160,56.22950819672131,5.5789360360578195,58.19155576722087
18,6,95,14,37,53,199,62.622950819672134,3.5064300173536926,53.87061916297418
12,4,63,36,84,41,224,66.72131147540983,5.561828646425559,47.71685987816461
11,4,97,12,28,20,157,55.73770491803279,3.039686438715882,61.22260864325133
4,4,88,7,4,78,177,59.01639344262295,4.535341369708442,56.44826518766861
5,1,9,4,73,80,166,57.213114754098356,5.308327738264671,57.47855750763697
21,6,20,59,91,21,191,61.31147540983606,5.80438655247835,52.88413803768559
3,1,45,72,20,37,174,58.52459016393442,5.727606408619462,55.747803427446115
18,4,90,0,70,98,258,72.29508196721312,5.458874608642935,42.24604342414395
19,7,26,35,66,79,206,63.77049180327869,5.664574048983912,50.564934147737404
0,6,65,34,46,7,152,54.91803278688525,3.5976590575112297,61.48430815560352
19,6,40,65,83,61,249,70.81967213114754,3.8525528871351864,45.32777498171727
16,5,12,62,82,46,202,63.11475409836065,3.8669055747631758,53.01834032687617
11,5,8,22,34,16,80,43.114754098360656,4.131161793005097,72.75408410863425
